きます、きる	着る	Ponerse (una camiseta, etc) (usado para ropa del torso)
はきます、はく	履く	Ponerse (calzada, pantalones, etc) (usado para ropa del torso)
かぶります、かぶる	被る	Ponerse (sombrero, etc)
かけます、かける	掛ける	Ponerse (gafas)
うまれます、うまれる	生まれる	Nacer
コート	Abrigo
スーツ	Traje
セーター	Sueter
ぼうし	帽子	Sombrero, Gorra
めがね	眼鏡	Gafas, Lentes
よく	Frecuentemente
おめでとうございます	Felicitaciones
こちら	Esto(formal de これ)
やちん	家賃	Alquiler de casa(el dinero)
うーん	Dejemer ver...(al estar pensando que decir)
ダイニングキチン	Cocina-comedor
わしつ	和室	Habitacion al estilo japones
おしいれ	押し入れ	Armario al estilo japones
ふとん	布団	Colchon y cobuja al estilo japones
アパート	Apartamento
パリ	Paris
ばんりのちょうじょう	万里の長城	La gran muralla china
