おもいます、おもう	思う	Pensar, Creer
いいます、いう	言う	Decir
たります、たる	足る	Ser suficiente
かちます、かつ	勝つ	Ganar
まけます、まける	負ける	Perder (el partido,etc.), Ser derrotado
あります、ある	Celebrarse, Tener lugar (el festival)
やくにたちます、やくにたつ	役に立つ	Ser util
むだ[な]	Desperdiciar, Malgastar
ふべん[な]	不便	Inconveniente
おなじ	同じ	Igual, Mismo
すごい	Horroroso, Maravilloso
しゅしょう	首相	Primer Ministro
だいとうりょう	大統領	Presidente de un pais
せいじ	政治	Politica
ニュース	Noticia
スピーチ	Discurso
しあい	試合	Partido (de futbol)
アルバイト	Trabajo part-time
いけん	意見	Opinion
[お]はなし	[お]話	Discurso, Cuento, Lo que uno dice
むだ	Desperdicio
デサイン	Diseño
こうつう	交通	Transporte, Trafico
ラッシュ	Hora punta
さいきん	最近	Ultimamente, Estos dias
たぶん	Probablemente, Quizas
きっと	Sin falta
ほんとうに	Realmente
そんなに	No tan(junto a una expresion negativa)
～について	Sobre~
しかたがありません	No hay remedio.
しばらくですね	Hace tanto tiempo (sin vernos)
もちろん	Naturalmente, Por supuesto
カンガルー	Canguro
