なきます、なく	泣く	Llorar
なきます、なく	鳴く	Llamado animal, Canto animal
なきやみます、なきやむ	泣き止む	Parar de llorar
はしります、はしる	走る	Correr
こけます、こける	Caerse (intransitivo)
もちます、もつ	持つ	Tener en mano
て	手	Mano
け	毛	Pelo, Pelaje
てのけ	手の毛	Pelo de mano
がいこく	外国	Pais extranjero
がいこくじん / がいこくのひと	外国人 / 外国の人	Extranjero
すき	好き	Gustar
ぶんか	文化	Cultura
じょうず	上手	Ser bueno en...
へた	下手	Ser malo en...
はやい	早い	Temprano, pronto
はやい	速い	Rapidamente
りょこう	旅行	Viaje
ちず	地図	Mapa
えいご	英語	Lenguaje ingles
ぜんぜん	全然	En lo absoluto, Completamente
あいさつ	挨拶	Saludo
きんちょう	緊張	Nervios (estado mental)
びょういん	病院	Hospital
かのじょ	彼女	Ella, Polola
さいご	最後	Final, Ultimo
せいせき	成績	Resultado, Notas (de pruebas)
おくります、おくる	送る	Mandar
がっこう	学校	Escuela
