つけます、つける	付ける	Encender, Prender
けします、けす	消す	Apagar (luz, aparatos electricos)
あけます、あける	開ける	Abrir
しめます、しめる	閉める	Cerrar
いそぎます、いそぐ	急ぐ	Apresurar, Darse prisa
まちます、まつ	待つ	Esperar
とめます、とめる	止める	Parar, Detener, Aparcar, Estacionar
まがります、まがる	曲がる	Doblar (a un direccion)
もちます、もつ	持つ	Tener algo en la mano
とります、とる	取る	Tomar (en la mano), Pasar (algo a alguien)
てつだいます、てつだう	手伝う	Ayudar
よびます、よぶ	呼ぶ	Llamar
はなします、はなす	話す	Hablar
みせます、みせる	見せる	Mostrar, Enseñar
おしえます、おしえる	教える	Dar, Enseñar 
はじめます、はじめる	始める	Empezar, Comenzar
ふります、ふる	降る	Llover
コピーします	Sacar fotocopias
エアコン	Aire acondicionado
パスポート	Pasaporte
なまえ	名前	Nombre
じゅうしょ	住所	Direccion, Domicilio
ちず	地図	Mapa, Plano
しお	塩	Sal
さとう	砂糖	Azucar
よみかた	読み方	Como leer, Modo de leer
かた	方	Como, Modo de, Manera de
ゆっくり	Despacio
すぐ	Inmediatamente
また	De nuevo
あとで	Después, Más tarde
もうすこし	もう少し	Un poco mas
もう	Mas, Otro
いいですよ	Con gusto
さあ	Expresión utilizada para alentar o animar a alguien a hacer algo
あれ？	Expresión utilizada ante una sorpresa
しんごう	信号	Semaforo
まっすぐ	Derecho, Recto
これでおねがいします。	これでお願いします。	Cobreme de esto
おつり	お釣り	Cambio, Vuelto
