おきます、おきる	起きる	Levantarse, Despertar
ねます、ねる	寝る	Acostarse, Ir a la cama, Dormir
さわります、さわる	触る	Tocar
あらいます、あらう	洗う	Lavar
つくります、つくる	作る	Hacer, Crear, Preparar(comida)
たべます、たべる	食べる	Comer
かたづけます、かたづける	片付ける	Ordenar
します、する	Hacer
きます、くる	来る	Venir
いきます、いく	行く	Ir
うけます、うける	受ける	Recibir, Obtener
おくります、おくる	送る	Mandar, Enviar
うたいます、うたう	歌う	Cantar
よみます、よむ	読む	Leer
かきます、かく	書く	Escribir
しにます、しぬ	死ぬ	Morir
あげます、あげる	上げる	Dar
くれます、くれる	呉れる	Dar
もらいます、もらう	貰う	Recibir
きがえます、きがえる	着替える	Cambiarse de ropa
おこります、おこる	怒る	Enojarse
なきます、なく	泣く	Llorar
みます、みる	見る	Mirar
はたらきます、はたらく	働く	Trabajar
のります、のる	乗る	Subirse (a un tren, un auto, etc)
はれ	晴れ	Despejado
あめ	雨	Lluvia
くもり	曇り	Nublado
たいふう	台風	Tifón
おかし	お菓子	Dulces
きれい	綺麗	Bonito
みじかい	短い	Corto
ながい	長い	Largo
おおきい	大きい	Grande
ちいさい	小さい	Pequeño
かっこい	格好いい	Atractivo
かわいい	可愛い	Adorable
しずかな	静かな	Silencioso
にぎやかな	賑やかな	Ruidoso
ひまな	暇な	Libre, Tiempo libre
たいくつ	退屈	Aburrido, Monotono
やすい	安い	Barato
たかい	高い	Caro
おもしろい	面白い	Interesante, Divertido
うれしい	嬉しい	Feliz
かなしい	悲しい	Triste
めんどくさい	面倒くさい	Tedioso
ふしぎな	不思議な	Extraño, Maravilloso
すてきな	素敵な	Maravilloso
むりな	無理な	Imposible
じょうきょう	状況	Situacion




la clase novena fue sobre conjugacion - mail llego sab 10 jun

la clase 10 - mail llego dom 18 jun

clase 11 - se hizo el lun 19 jun - tengo el archivo

clase 12 - se hizo el 03 de julio - llego archivo 9 de julio

clase 13 - se hizo el 10 de julio- llego el 15

clase 14 - se hizo el 17 de julio
